label	replace by
商	趙商
十有二	十二
制度	制
毛	毛公
書說	尚書緯
毛公傳	毛詩傳
毛本	毛詩傳
書	尚書
周家	周
禮記明堂位	明堂位
小記	喪服小記
外傳	囯語
冢宰	塚宰
周官	周禮
內傳	左傳
外傳	國語
幽	幽王
厲	厲王
左氏	左傳
子春	杜子春
再	二
召伯	召公
人君	君
春秋經	春秋
春秋傳	公羊傳
顓頊氏	顓頊
帝顓頊	顓頊
曹	曹国
共工氏	共工